#####################
#     # #           #
# ### # # ### ##### #
# # # #     # #     #
### # ####### #######
#   #       #       #
# # ####### # ##### #
# #   #     # #   # #
# ### # ##### # # # #
# #   # #     # #   #
# # ### # ##### ### #
# #   # #   #   # # #
# ### # # ### ### # #
# #   # # #   #   # #
# # ### ### ### # # #
# #   #   # # # #   #
# ### ### # # # #####
# #     # # # #   # #
# ####### # # ### # #
#           #       #
#####################
