####################
# #       #   # # ##
# ### ####### # # ##
# #     #   #     ##
# # ####### ##### ##
#       # #   #   ##
# ####### # ##### ##
#     # #         ##
# ##### ##### ######
# #   # #   #   # ##
# # ### ### # ### ##
# #   #     # #   ##
# # ##### ### # ####
# #     #         ##
# # ####### # ### ##
#     # # # # # # ##
##### # # # ### ####
#                 ##
####################
####################
