##################################################
#       #         #     #               #       ##
### ### # ####### ### # ### ########### # ### ####
#   # #   #     #     # #   #   #     # #   #   ##
# ### ##### ########### # ### # # ### # ### ### ##
# #         #           # #   # # # # # #   #   ##
# ######### # ########### ### ### # # # ##### # ##
# #   #   #     #         #   #   # # #   #   # ##
# # # # # ##### ##### ##### # # ### # ### # ### ##
#   #   #   # #     # #     # # #   #   # # # # ##
# ######### # ##### # # ####### # # # # # # # # ##
# #       # #         #     #   # # # # #   # # ##
# # ##### # ########### ### # ### ### ####### # ##
# # #     #       #       #   # #   #       #   ##
# ### ### ####### # ##### ##### # # ### ### # ####
#     # #       # # #   # #       #   # #   #   ##
####### ####### # ### # # # ######### # # ##### ##
#   #         # # #   # # # #       # # # #     ##
# # # ### ##### # # ### # ### ##### # # ### ######
# # #   # #     #   #   #     #     # #     #   ##
# ##### # # ####### # ######### ##### ##### ### ##
# #     #   # #   # # #     #         #   #     ##
# # ######### # # ### # # ### ####### # # ##### ##
#   #         # # #   # # #     #   # # # #   # ##
# ####### ##### # # ### # # ##### # ### # # # ####
#         #   # # # #   #   #   # # #   # # #   ##
##### ##### # # # # # ####### # # # # ### # ### ##
# #   #     #   #   # # #     #   #   #   # #   ##
# # ### ############# # ############### ### # ####
#   # #       #     # #     #   #     # #   # # ##
# ### ####### # ### # # ### # # ### # # ### # # ##
# #   #     #   # # #   # #   #     # #     # # ##
# # # # ######### # ##### ########### ####### # ##
# # # #         # #   #             # #     #   ##
# # # ### # ### # ### ##### ##### # # ### # ### ##
#   #   # # # #   #   #   # #   # # # #   # # # ##
####### ### # ### # ### # # # # # ### # ### # # ##
#     #   # #     # #   # # # # # #   #   #   # ##
# ####### # ####### # ### ### # # # ##### ##### ##
#       #   #       # # #     # # # #     #     ##
####### ### # ####### # ####### # # # ##### ######
#   #     # #         #       # # #   #   # #   ##
# # # ##### ########### ### ### # ### # # # ### ##
# # # #     #     #     #   #   # #   # # #     ##
# # # # ####### # ####### # # ### # ### # ##### ##
# #   # #     # # #     # # # #       # # #     ##
# ##### # ### # # # ### # # # ######### # # ######
#         #     #   #     # #           #       ##
##################################################
##################################################
