####################
#W#N#NNGNW#WWGNWGN##
#W#N#####N#######N##
#GGGGWGGWWGNWGGNWW##
#####G#########W#N##
#NNGWW#NWG#W#N#W#N##
#N#G###N###G#W###W##
#G#W#W#WNGNNGW#N#N##
#####N#G###N#G#G#G##
#N#N#GNG#WGW#NGGNN##
#W#G#W#W###N###W#G##
#NNNGW#G#WGG#WGW#W##
#G###G#######G###N##
#NWG#GNNNWWN#N#G#G##
###W#N#########N#G##
#NGN#N#WNNGGGWGNWW##
#G#####G#G###N#W#N##
#N#GNWWN#W#WWN#W#G##
####################
####################
