####################
#       # #   #   ##
# # ### # # ### # ##
# # #   #     # # ##
####### ### ##### ##
#     #       #   ##
### ### ##### ### ##
#         # #     ##
### ### ### # ######
#   #   #         ##
# # # ### # # # ####
# # # # # # # #   ##
# ##### # ### # ####
# #       #   #   ##
# ####### ### # ####
# #   #     # #   ##
##### # # # # ### ##
#       # # # #   ##
####################
####################
