####################
# #       #     # ##
# # ####### # # # ##
# # #     # # #   ##
# # # ### # # ######
# #   # # # #     ##
# ##### # ####### ##
#       #       # ##
# ##### ####### # ##
#   # #       # # ##
### # ##### ### # ##
#   #   # #     # ##
# ### # # ####### ##
#     #     #     ##
########### ### # ##
#   #       #   # ##
# ### ####### ### ##
#             #   ##
####################
####################
