####################
#S......# #   #   ##
# # ###.# # ### # ##
# # #  .#     # # ##
#######.### ##### ##
#     #.......#   ##
### ### #####.### ##
#         # #.    ##
### ### ### #.######
#   #   #E....    ##
# # # ### # # # ####
# # # # # # # #   ##
# ##### # ### # ####
# #       #   #   ##
# ####### ### # ####
# #   #     # #   ##
##### # # # # ### ##
#       # # # #   ##
####################
####################
